**** ***************************************************************************
*               *     *   *                                 *          *       *
***  *          *     *   *                                            *       *
*               *     *****                                            *       *
*               *                                                      *       *
*               *                                           *     ******       *
*               *                  *                        *          *       *
*               *                  *                        *          *       *
*               *                  *                        *          *       *
*                                  *                        *          *       *
*                                  *                        *          *       *
*      *****************************                                           *
*                                  *                                           *
*                                  *           *********************************
*               *                  *                                           *
*                                  *                                           *
*               *                  *                        *                  *
*                                  *                        *                  *
*               *                                           *                  *
*                                                           *                  *
*               *                                           *                  *
*               *                                           *                  *
********************************************************************************
