********************************************************************************
*                                                                              *
*                                                                              *
*                                                                              *
*                                                                              *
*                                                                              *
*                                  *                                           *
*                                  *                                           *
*                                  *                                           *
*                                  *                                           *
*                                  *                                           *
*                                  *                                           *
*                                  *                                           *
*                                  *                                           *
*                                  *                                           *
*                                  *                                           *
*                                  *                                           *
*                                  *                                           *
*                                                                              *
*                                                                              *
*                                                                              *
*                                                                              *
********************************************************************************
